                                                               X 
                                                               X
                                                               X
                                                    XXX        X
                                                               X
                                                               X
         X                                                XXXXXX
         XXXXXXXXXX                                            X     XXXXXXXXXXXXXXXXXXXXXX
                                                    XXX        X     X                    X
                                                               XXXXXXX                    X
                                          XXXX                                            X
                      P                                                                    X
                 XXXXXX                                                                   X
                             X                     XXXXX                                  X
                                                              XXXXXXX                    X
X                                                              X     X                    X
X            M      S                         X          M  XXXX     X                    X
X                                                              X     XXXXXXXXXXXXXXXXXXXXXX
X                    X          XXXXX                          X                          X
X     X                                                                                   X
X                                                                                         X
X                                   X        M                                            X
X       S                            Q                                                    X
XXXXXXXXXXXXXXXXXXXXXXXXXXXXXXXXXXXXXXXXXXXXXXXXXX S       XXXXXXXXXXXXXXXXXXXXXXXXXXXXXXXX
                                                 X         X
                                                 X       XXX
                                                 X         X
                                                 X         X
                                                 X         X
                                                 XXX       X
                              M                  X         X
                                                 X         Q
                                                 X       XXXXXXXXXXXXXXXXXXXXXXXXXXXXXXXXXXXX
                                                 X                                          X
                                                 X                                          X
                                                 X                                          X
                           S                     X                                          X
                                                 XXXXXXXXXXXXXXXXXXXXXXXXXXXXXXXXXXXXXXXXXXXX