                                                               X 
                                                               X
                                                               X
                                                    XXX        X
                                                               X
                                                               X
         X                                                XXXXXX
         XXXXXXXXXX                                            X     XXXXXXXXXXXXXXXXXXXXXX
                                                    XXX        X     X                    X
                                                               XXXXXXX                    X
                                          XXXX                                            X
                      P                                                                    X
                 XXXXXX                                                                   X
                             X                     XXXXX                                  X
                                                              XXXXXXX                    X
X                                                              X     X                    X
X                                             X             XXXX     X                    X
X                                                              X     XXXXXXXXXXXXXXXXXXXXXX
X                    X          XXXXX                          X                          X
X     X                                                                                   X
X                                                                                         X
X                                    X                                                    X
X                                    X                                                    X
XXXXXXXXXXXXXXXXXXXXXXXXXXXXXXXXXXXXXXXXXXXXXXXXXX         XXXXXXXXXXXXXXXXXXXXXXXXXXXXXXXX
                                                 X         X
                                                 X       XXX
                                                 X         X
                                                 X         X
                                                 X         X
                                                 XXX       X
                                                 X         X
                                                 X         X
                                                 X       XXXXXXXXXXXXXXXXXXXXXXXXXXXXXXXXXXXX
                                                 X                                          X
                                                 X                                          X
                                                 X                                          X
                                                 X                                          X
                                                 XXXXXXXXXXXXXXXXXXXXXXXXXXXXXXXXXXXXXXXXXXXX