X                                                                                       X
X                                                                                       X
X                                                                                       X
X                                                                                       X
X                                                                                       X
X                      S                                                                X
X                     XXXX                  XXXX                                        X
X               XXXX                              XXXX                                  X
X        XXXX                                            XXXX                           X
X                                                                                       X
X                                                                                       X
X                                                                                       X
X                                                                                       X
X                                                                                       X
X                                                                                       X
X                                                                                       X
X                                                                                       X
X                                                                                       X
X                                                                                       X
X                                                                                       X
X                                 P                                                     X
X            M            QQQQQQQQQQQQQQQQQQ   B                  S                     X
XXXXXXXXXXXXXXXXXXXXXXXXXXXXXXXXXXXXXXXXXXXXXXXXXXXXXXXXXXXXXXXXXXXXXXXXXXXXXXXXXXXXXXXXX